"Account","Date","ChkNum","Payee","Category","Class","Memo","Amount","Cleared","CurrencyCode","ExchangeRate","Balance"
"Barclays","24/09/2024","Direct Debit","ID Mobile","Children:Phone","","Eirwen ","-6.00","*","GBP","1.0","25,528.17"
"Barclays","24/09/2024","Direct Debit","ID Mobile","Children:Phone","","Olen","-17.99","*","GBP","1.0","25,510.18"
"Barclays","24/09/2024","Direct Debit","ID Mobile","Personal:Phone","","Final payment","-1.05","*","GBP","1.0","25,509.13"
"Barclays","30/09/2024","Direct Debit","Utility Warehouse","House:Bills","Direct Debit","Gas","-105.86","","GBP","1.0","30,502.81"
"Barclays","30/09/2024","Direct Debit","Utility Warehouse","House:Bills","Direct Debit","Electric","-121.95","","GBP","1.0","30,380.86"
"Barclays","30/09/2024","Direct Debit","Utility Warehouse","House:Bills","Direct Debit","Phone, broadband etc","-53.97","","GBP","1.0","30,326.89"
"Barclays","30/09/2024","Direct Debit","Utility Warehouse","House:Bills","","House insurance","-27.19","","GBP","1.0","30,299.70"
"Barclays","30/09/2024","Direct Debit","Utility Warehouse","Refund","","","21.43","","GBP","1.0","30,321.13"
"Barclays","30/09/2024","","World Wildlife Fund","Children","","Eirwen","-3.00","","GBP","1.0","30,318.13"
